0000000099999999900
0000000911111111190
0009009111111111119
0091999111111111119
0091111111111111119
0091999111111111119
0009009111111111119
0000000911111111190
0000000099999999900